00000000000000000000
00000000000000000000
00002000000000000000
00000000000000000000
00000000000000000000
00000000222222000000
00000000000002000000
00000000000002000000
00000000000002000000
00000000000000000000
00002000020000000000
00002000020000000000
00002222220000000000
00000000000000000000
00000000000000000000
